##########
#     p  #
#  ..    #
#  oo    #
#        #
##########
